абитура – абитуриенты
бабло – деньги
бабки – деньги
бабник – любитель ухаживать за женщинами
балда – бестолковый человек, дурак
балдеть –  проводить время в бездействии, праздности
барахло – старьё, старые вещи; что-то плохое, негодное
бардак – полный беспорядок, хаос
блин – определённой смысловой нагрузки не несёт, может выражать досаду, раздражение, удивление
бомбить – заниматься частным извозом
ботаник – человек, который слишком много занимается,
в ущерб личной жизни; вечно учащийся, скучный человек, зануда
быдло только – человек низкой культуры, плохо воспитанный; безвольные покорные люди, подчиняющиеся
чьей-либо воле
валить – уходить; Вали отсюда!
вкалывать – напряженно работать; выполнять тяжёлую работу
влом – нежелание делать что-либо; Мне влом
гулять с собакой, пусть Нина идёт.
водила – водитель
впаривать, впарить – навязывать что-либо; убедить в чём-либо, используя навязчивые методы
в пролёте – упустить какую-либо возможность
врубать, врубить – включать что-либо; врубить громкую музыку
врубаться, врубиться — понимать, догадываться; Это трудно понять; я не врубаюсь в эту ситуацию.
втюхивать, втюхать – настойчиво пытаться продать что-либо; навязывать свою точку зрения

выпендриваться, выпендриться – важничать, всеми способами стараться обратить на себя внимание
выпроваживать, выпроводить – вынуждать уйти, удалять кого-либо откуда-либо
вырубать, вырубить – ударить так, чтобы человек потерял сознание; выключить
геймер – игрок в компьютерные игры
глюк – сбой в работе техники; галлюцинация
глючить – технике: работать с перебоями, с ошибками;  У меня телефон глючит.
гнать – врать
гнать волну – накалять обстановку, идти на конфликт
грабли – руки
грузить – словесно убеждать человека сделать что-либо, чего он делать не хочет; говорить что-либо неприятное или неинтересное для слушателя; Хватит меня грузить!
гуглить – искать информацию через поисковую систему Google
дебил – тупой, несообразительный человёк
динамить, продинамить – нарушать договорённость, не сдерживать обещание
догонять – понимать
доставать, достать – надоедать, надоесть; Как же ты меня достал!
доходяга – обессилевший, истощённый человек
дрыхнуть – спать
дубина – тупой, глупый человек
дурень – глупец, дурак
дурь – наркотик
дылда – высокий нескладный человек
ежу понятно –  то, что совершенно просто, очевидно, что Ясно любому человеку
жлоб – жадный, тупой, злой человек
жмот – жадный человек; скряга, скупец
жратва – еда
забивать, забить – не обращать внимания; Забей на это!
заваливаться, завалиться – приходить, прийти
зависать, зависнуть – перестать работать, отвечать на действия пользователя
завязать, завязывать – прекращать делать что-либо
загнать, загонять – продавать, продать
зажечь, зажигать – очень сильно веселиться
замётано – ладно, договорились
заморочка – затруднение, трудность, проблема; навязчивая идея
западать, запасть – влюбляться, влюбиться
зараза
зарубить – не дать разрешения, запретить
зафигачить –  изготовить, сделать; поместить, разместить; зафигачили статью о молодёжи; ударить; Я ему в глаз зафигачил.
зацикливаться, зациклиться – начать повторяться; сосредоточиться на чём-либо одном идиот; глупый человек, тупица, дурак
инфа – информация
кайф – наслаждение, удовольствие
кайфовать – наслаждаться, получать удовольствие
кантоваться, перекантоваться – находиться где-либо временно
катиться – уходить; Катись отсюда!
качать – переписывать файл на другой носитель
качаться – заниматься физкультурой, бодибилдингом
кидать, кинуть – обмануть, смошенничать; поставить в трудное положение
Класс! – высшая положительная оценка
классно – высшая положительная оценка
клеить – общаться с человеком противоположного пола с целью завязать отношения; приставать
клеиться – ухаживать, приставать, заигрывать
клёвый, клёво – хороший, отличный, классный
кликать, кликнуть – на компьютере: наводить курсор и нажимать на клавишу мышки, чтобы открыть ссылку
колбасить – плохо себя чувствовать; Меня колбасит.
колёса – таблетки наркотического действия
комп – компьютер
копец – конёц чего-либо, катастрофа; междометие
кореш – друг, приятель
корпоратив – вечер в ресторане или вечеринка для сотрудников и руководителей за счёт фирмы
косить, откосить – от уклоняться от службы в армии; только нсв Иод стараться быть похожим на кого-либо; косить под крутого; избегать отвётственности; избегать кого-либо
косяк – ошибка, неправильное действие
косячить, накосячить – ошибиться, неправильно сделать что-либо
кретин, кретинка – слабоумный человек, идиот
крутой, круто – замечательный; очень хороший
крыша едет – неадекватное поведёние человека, ненормальное психическое состояние
лажа – нечто низкосортное, плохого качества; Фильм ужасный, полная лажа!
лимон – миллион
лопух – несообразительный, глупый человек
лопухнуться – упустить удобный случай, проявить несообразительность; ошибиться
лох – необразованный, ограниченный человек; невнимательный человек, разиня; Он такой лох, его каждый обманет.
лохануться  – допустить промах, попасть в неприятную ситуацию
лузер – человек, жизнь которого складывается неудачно, неудачник
мажор – материально обеспечённый молодой человек; подросток из состоятельной семьй
маразм – что-либо нелёпое, плохое
морда – лицо; о неприятном человеке
мурыжить – затягивать решение какого-либо вопроса, заставлять долго ждать
мухлевать, смухлевать – мошенничать, жульничать
мыло – письмо, посланное по электронной почте
навороченный – снабжённый сложными приборами, деталями; навороченный компьютер
наезжать, наехать – предъявлять претензии, обвинять вчём-либо, ругать, угрожать, желая добиться чего-либо
нал – наличные деньги; платить налом
накрываться, накрыться – перестать функционировать, сломаться; У меня компнакрылся.
на мази – о благоприятном ходе дела
напрягать – заставлять кого-либо делать что-либо; вызывать неприятные эмоции
нарываться, нарваться – сознательно совершать действия, ведущие к неприятным последствиям, конфликту
нарыть – с трудом добыть, найти что-либо; нарыть много информации
нахапать – хватая, присваивать себе что-либо в большом количестве
непруха – невезение, неудача, полоса неудач; Что за непруха?!
неформал – человек, который отличается от других; член неформальной организации
ныкать, заныкать – прятать, спрятать
обалдевать, обалдеть – потерять способность понимать, не соображать; Я обалдел, когда это узнал.
обалденный, обалденно – отличный, прекрасный, великолепный
обдурить – обмануть, одурачить
облажаться – попасть в неловкое, неприятное положение; потерпеть неудачу
облом – неудача, крушёние планов; Облом — билетов нет.
отваливать, отвалить – отойти, уйти; Отвали!
отморозок – глупый, лишённый эмоций и моральных принципов человек
отпад – выражение сильного удивления, восхищения; Вечеринка — отпад!
отрываться, оторваться – развлекаться, расслабляться, забыв о повседневной жизни
отстой – о чём-то плохом, некачественном; нечто устаревшее, несовременное, вышедшее из моды
оттягиваться, оттянуться – хорошо отдыхать; получать удовольствие

отфутббливать, отфутболить – избавляться от кого-либо, от чего-либо, отправив в другие инстанции, спроваживать
офигённый, офигенно – прекрасный, бесподобный, необыкновенный
офигеть – прийти в крайнее изумление
офонареть – потерять способность соображать, быть не в себе
охренеть – потерять голову; поразиться; быть не в себе
паразит – плохой человек; человек, совершивший дурной поступок
париться – переживать, волноваться, нервничать, чаще с отрицанием; Не парься!
пахать – работать много и добросовестно
переплюнуть – превзойти кого-либо в чём-либо, показать лучший результат
переть – двигаться, не считаясь с запретами и пре
пятствиями; Куда прёшь?!
перец – парень
Плевать!, Наплевать! – пренебрегать чем-либо, относиться безразлично
поддавать, поддать – выпить спиртного
подкаблучник – мужчина, который находится в полном подчинении под каблуком у жены
подкалывать, подколоть – шутить, смеяться над кем-либо
подкачать – стать неудачным, плохим; Здоровье подкачало.
подонок – низкий, подлый человек, подлец
подставлять, подставить – поставить кого-либо, что-либо в неприятное или опасное положение, чаще нечестным путём; Поймите, мы об этом не знали, нас подставили.
попса – популярное музыкальное произведение, рассчитанное на малокультурную публику; аудитория малокульгурных слушателей
порнуха – порнографическая литература, фото, фильмы
портачить, напортачить – делать что-либо плохо, испортить
пофигизм – полное равнодушие, безразличие
пофигист, пофигистка – равнодушный ко всему человёк; бездельник
придурок – глупый человек, дурак
прикалываться, приколоться – смеяться, шутить над кем-либо, над чем-либо; высмеять кого-либо
прикид – одежда
прикинуть – представить себе что-либо; Прикинь!
прикол – шутка, розыгрыш
приколис,; приколистка – шутник, юморист
прикольный, прикольно – смешной, забавный; что-либо смешное
продвинутый – человек, лучше других знающий о чём-либо
пройдоха – хитрый, жуликоватый человек
псих – психически неуравновёшенный, психически больной человек
разводить, развести – обманывать
раскручивать. раскрутить – заставить кого-либо, вынудить сделать что-либо невыгодное для него; создать хорошую рекламу исполнителю (группе) или товару; Он легко раскручивает молодых артистов.
ржать нсв [; груб., неодобр. // громко хохотать
рожа – неприятное или страшное лицо; человек с неприятным лицом; корчить рожи
сбагривать, сбагрить – избавиться от чего-либо ненужного, мешающего
сбрендить – сказать или сделать глупость; сойти с ума
сваливать, свалить – исчезнуть из какого-либо места незаметно и быстро
сволочь – негодяй, очень плохой человек
сдуру – по глупости сделать что-либо
скачивать, скачать – переписать файл на другой носитель
скидываться, скинуться – собрать деньги на совместную покупку, собирать средства для общей цели
скотина – непорядочный, грубый человёк
смайлик, смайл – знак улыбки при общении в Интернете
сморозить – сказать что-либо глупое, нелепое; сморозить глупость
спереть – украсть
спятить св – сойти с ума
стебаться – смеяться, шутить над кём-либо; веселиться, смеяться
стерва – подлый человек; сварливая нетерпимая женщина
стрёмный, стрёмно – опасный; страшно, опасно; стыдно; Стрёмно ходить в такой одежде.
схомячить,хомячить –  нечто странное, нелепое
тачка – такси или машина
тащиться – испытывать удовольствие, наслаждаться
тварь – о плохом человеке
тормоз – несообразительный человек; глуповатый
трепаться – говорить глупости; проводить время в пустых разговорах
трепло – болтун, лживый человек
тупить – не понимать чего-либо
тусоваться – весело, приятно проводить время в компании, в клубе; проводить врёмя в общении, разговорах с кём-либо
тусовка – неформальное общение без соблюдения рангов, мероприятие развлекательного характера; компания, неформальная группа
туфта – нечто ненастоящее, плохого качества, халтура
тюфяк – безвольный, вялый, неэнергичный человек
убойный – потрясающий, производящий сильное впечатление
ужастик – фильм или книга ужасов; Какие фильмы ты любишь? Ужастики.
улётный – замечательный, интересный
универ – университет
урод – человек с дурным характером, без моральных принципов
фан, фанат – преданный страстный поклонник кого-либо, чего-либо; Мой сосед — фанат футбольной команды «Динамо».
фигня – ерунда, чепуха, что-либо бесполезное
фиолетово – мне безразлично
фрукт – Он ещё тот фрукт.
фуфло – о чём-либо очень плохом, некачественном, сквёрном
хавчик – еда, продукты
халява – получение чего-либо за чужой счёт, бесплатно; пообедать на халяву
хам, хамка – грубый, наглый человек
хапать, хапнуть – грубо хватать; незаконно присваивать
хомячить, схомячить – есть, съесть что-либо
хохма – что-либо смешно, шутка, высказывание, случай
хохмить, схохмить – шутить, пошутить
хрень – ерунда, чушь; нечто ненужное, низкокачественное; любая вещь
чайник – неопытный пользователь компьютера; новичок в каком-либо деле
чернуха – художественное произведение, изображающие мрачные стороны жизни
чокнутый – несовсем нормальный человек
чувак – молодой человек
чувиха – девушка, молодая женщина
шмотки – одежда, личные вещи; Они говорят только о шмотках.
шпана – хулиган, жулик
юзер – пользователь компьютера
ящик – телевизор